{
    "id": "forest",
    "name": "map_forest",
    "bgColor": "#789262",
    "grid": [
        [0,0,0,0,0,0,0,0,0,0,0,0,0,0,0],
        [0,3,3,0,0,2,2,2,0,0,0,3,3,0,0],
        [0,3,1,1,0,0,0,0,0,0,1,1,3,0,0],
        [0,0,1,1,0,0,0,0,0,0,1,1,0,0,0],
        [0,0,0,0,0,2,0,0,0,2,0,0,0,0,0],
        [0,2,0,0,0,2,0,0,0,2,0,0,0,2,0],
        [0,2,0,0,0,0,0,3,0,0,0,0,0,2,0],
        [0,2,0,0,0,0,3,3,3,0,0,0,0,2,0],
        [0,2,0,0,0,0,0,3,0,0,0,0,0,2,0],
        [0,2,0,0,0,2,0,0,0,2,0,0,0,2,0],
        [0,0,0,0,0,2,0,0,0,2,0,0,0,0,0],
        [0,0,1,1,0,0,0,0,0,0,1,1,0,0,0],
        [0,3,1,1,0,0,0,0,0,0,1,1,3,0,0],
        [0,3,3,0,0,2,2,2,0,0,0,3,3,0,0],
        [0,0,0,0,0,0,0,0,0,0,0,0,0,0,0]
    ]
}